###########
#....#....#
#.##.#.##.#
#.##.#.##.#
#.........#
###.###.###
###.....###
   .# #.   
###.#g#.###
###.###.###
#.........#
#.##.#.##.#
#.##.#.##.#
#..p.#....#
###########
